*E*******
*      S*
** ** ***
* * *   *
* * *****
* * *   *
* * **  *
*   * * *
*********