*E*******
* *      
** ** *  
* * * *  
* * *** *
* * *    
* * **** 
*S*  * * 
*********