*E*******
* *      
* *** *  
* * * *  
* * *** *
* * *    
**  * * 
* * S     
*********